NO ./fig/sas.xpm
EA ./fig/miltank.xpm
WE ./fig/64.xpm
SO ./fig/120.xpm
                  
F 51,250,51
C 255,0,0

111111111111111111111
100000000000000000001
100000000000000000001
101100000000000000001
1001N0000000000000001
111111111111111111111
