NO ./fig/sas.xpm
SO ./fig/miltank.xpm
WE ./fig/64.xpm
EA ./fig/120.xpm
                  
C 51,250,51
F 36,85,1

1111111111111111111111111111111111
1111111111000000000110000000000001
100000000111000000000N001111111111
1011000000000000000000001
1001000000000000000000001
1111111111111111111111111
