NO ./assets/textures/map1_no.xpm
SO ./assets/textures/map1_so.xpm
WE ./assets/textures/map1_we.xpm
EA ./assets/textures/map1_ea.xpm

C 51,53,51
F 36,85,1

1111111111111111111111111
1000000000110000000000001
100000000011000000000N001
1011000000000000000000001
1001000000000000000000001
1111111111111111111111111