NO ./assets/textures/map2_no.xpm
SO ./assets/textures/map2_so.xpm
WE ./assets/textures/map2_we.xpm
EA ./assets/textures/map2_ea.xpm

C 51,53,51
F 36,85,1

11111111111111111111111111111111111111111111111111
10000000000000000000000000000000000000000000000001
10000000000000000000000000000000000000000000000001
10000000000000000000000000000000000000000000000001
10000000000000000000000000000000000000000000000000
10000000000000000000000000000000000000000000000001
10000000000000000000111000000000000000000000000001
10000000000000000000000000000000000000000000000001
10000000000000000000000000000000000000000000000001
10000000000000000000000000000000000000000000000001
10000000000000000000000000000000000000000000000001
1N000000000000000000000000000000000000000000000001
11111111111111111111111111111111111111111111111111