NO ./map/fig/sas.xpm
EA ./map/fig/miltank.xpm
WE ./map/fig/64.xpm
SO ./map/fig/120.xpm

F 51,250,51
C 255,0,2

111111111111111111111
100000000000000000001
100000000000000000001
101100000000000000001
1001N0000000000000001
111111111111111111111
